1111111111111111111111111111111111111111111111111111111111111111111111111111111
1000000000000000000000000000000000000000000000000001000000000000000000000000001
100000000000C000000000000000000000000000000000000001000000000000000000000000001
100000C000000000000000000000000000000000000000000001000000000000000000000000001
1000000000000000000000000000000000000000000000000000000000000000000000000000001
1000000000000000000000000000000000000000000000000000000000000000000000000000001
1C00000000000000000000000000000000000000000000000000000000000000000000000000001
1000000000000000000000000000000000000000000000000000000000000000000000000000001
1000000000000000000001000000000000111100000000000001000000000C00000000000000001
10000000000000000000101C0000000000100011000000000001000000000000000000000000001
1000000000000000000100010000000000100000110000000001000000000000000000000000001
1000000000000000001000001000000000100000001000000001000000000000000000000000001
1000000000000000011111111100000000100000001000000001000000000000000000000000001
1000000000000000100000000010000000100000010000000001000000C00000000000000000001
1000000000000001000000000001000000100001100000000001000000000000000000000000001
100000000000001000000P00000010000011111CC00000000001000000000000000000000000001
1000000000000000000000000000000000000000000000000000000000000000000000000000001
1000000000000000000000000000000C00000000000000000000000000011111111111111111111
1000000000000000000000000000000000000000000000000000000000011111101111111111111
1000000000000000000000000000000000000000000000000000000000011111101111111111111
1000000000000000000000000000000000000000000000000000000000011111100000000000001
100000000000000000000000000000E000000000000000000000000000011111100000000000001
1000000000000000000000000000000000000000000000000000000000011111100000000000001
1000000000000000000000000000000000000000000000000000000000000000000000000000001
1000000000000000000000000000000000000000000000000001000000000000000000000000001
1000000000000000000000000000000000000000000000000001000000000000000000000000001
1000000000000000000000000000000000000000000000000001000000000000000000000000001
1000000000000000000001111111111111111111111111111111000000000000000000000000001
1000000000000000000000000000000000111111110000000001000000000000000000000000001
1000000000000000000000000000000000111111110000000001000000000000000000000000001
1000000000000000000000000000000000111111110000000001000000000000000000000000001
1000000000000000000000000000000000111111110000000001000000000000000000000000001
1000000000000000000000000000000000111111110000000001000000000000000000000000001
1000000000000000000000000000000000111111110000000001000000000000000000000000001
1000000000000000000000000000000000000000001100000001000000000000000000000000001
1000000000000000000000000000000001111111111111110001000000000000000000000000001
1000000000000000000000000000000000000000000000000001000000000000000000000000001
1000000000000000000000000000000000000000000000000001000000000000000000000000001
1000000000000000000000000000000000000000000000000001000000000000000000000000001
1000000000000000000000000000000000000000000000000001000000000000000000000000001
1000000000000000000000000000000000000000000000000001000000000000000000000000001
1111111111111111111111111111111111111111111111111111111111111111111111111111111