# **************************************************************************** #
#                                                                              #
#                                                         :::      ::::::::    #
#    big_map.ber                                        :+:      :+:    :+:    #
#                                                     +:+ +:+         +:+      #
#    By: amanasse <amanasse@student.42.fr>          +#+  +:+       +#+         #
#                                                 +#+#+#+#+#+   +#+            #
#    Created: Invalid date        by 00000000000       #+#    #+#              #
#    Updated: 2022/08/30 14:39:58 by amanasse         ###   ########.fr        #
#                                                                              #
# **************************************************************************** #

10000000000000000000000000000000000000000000000000010000000000000000000000000001
10000000000000000000000000000000000000000000000000010000000000000000000000000001
10000000000000000000000000000000000000000000000000010000000000000000000000000001
10000000000000000000000000000000000000000000000000010000000000000000000000000001
10000000000000000000000000000000000000000000000000010000000000000000000000000001
10000000000000000000000000000000000000000000000000010000000000000000000000000001
10000000000000000000000000000000000000000000000000010000000000000000000000000001
10000000000000000000000000000000000000000000000000010000000000000000000000000001
10000000000000000000000000000000000000000000000000010000000000000000000000000001
10000000000000000000000000000000000000000000000000010000000000000000000000000001
10000000000000000000000000000000000000000000000000010000000000000000000000000001
10000000000000000000000000000000000000000000000000010000000000000000000000000001
10000000000000000000000000000000000000000000000000010000000000000000000000000001
10000000000000000000000000000000000000000000000000010000000000000000000000000001
10000000000000000000000000000000000000000000000000010000000000000000000000000001
10000000000000000000000000000000000000000000000000010000000000000000000000000001
10000000000000000000000000000000000000000000000000010000000000000000000000000001
10000000000000000000000000000000000000000000000000010000000000000000000000000001
10000000000000000000000000000000000000000000000000010000000000000000000000000001
10000000000000000000000000000000000000000000000000010000000000000000000000000001
10000000000000000000000000000000000000000000000000010000000000000000000000000001
10000000000000000000000000000000000000000000000000010000000000000000000000000001
10000000000000000000000000000000000000000000000000010000000000000000000000000001
10000000000000000000000000000000000000000000000000010000000000000000000000000001
10000000000000000000000000000000000000000000000000010000000000000000000000000001
10000000000000000000000000000000000000000000000000010000000000000000000000000001
10000000000000000000000000000000000000000000000000010000000000000000000000000001
10000000000000000000000000000000000000000000000000010000000000000000000000000001
10000000000000000000000000000000000000000000000000010000000000000000000000000001
11111111111111111111111111111111111111111111111111111111111111111111111111111111