11111111111111111111111111
11111111111111111111111111
11111111111111111111111111
1C010E000100000000100000C1
1C0100000100000000100000C1
1C0100000100000000100000C1
1001110000001110000E000001
1P00000C0000000011000000C1
11111111111111111111111111
11111111111111111111111111
11111111111111111111111111