1111111111111111111111111111111111111111111111111111111111111111111111111111111
1111111111111111111111111111111111111111111111111111111111111111111111111111111
1111111111111111111111111111111111111111111111111111111111111111111111111111111
1111110000000000000000000000011111110000000000000000000000000000000000001111111
111111000000000000000000000000011111100000C000000000000000000000000000001111111
1111110000000000000000000000000011111100000000000000000000000000000000001111111
1111110000000000000000000000000011111100000000000000000000000000000000001111111
1111110000000000000000000000000011111100000000000000000000000000000000001111111
1111110000000000000000000000000000000000000000000000000000000000000000011111111
1111110000000000000000000000000000000000000000000000000000000000000001111111111
1111110000000000000000000000000000000000000000000000000011111111111111111111111
1111110000000000000001111111111000000000000000000000000011111111111111111111111
1111110000000000001111E11111111111111111111111111100000011111111111111111111111
1111110000000000000000000000000111111111111111111100000011111111111111111111111
1111110000000000000000000000000111111111111111111100000011111111111111111111111
1111110000000000000000000000E00000000000000111111111111111111111000000001111111
1111110000000000000000000000000000000000000111111111111111111111000000001111111
1111110000000000000000000000000000000000000000000011111111111111000000001111111
11111100000000000P0000000000000000000000000000000011111111111111000000001111111
1111110000000000000000000000000000000000000000000011111111111111000000001111111
1111110000000000000000000000000000000000000000000011111111111111000000001111111
1111110000000000000000000000000000000000000000000000000000000000000000001111111
1111110000000000000000000000000000000000000000000000000000000000000000001111111
1111110000000000000000000000000000000000000000000000000000000000000000001111111
1111110000000000000000000000000000000000000000000000000000000000000000001111111
1111110000000000000000000000000000000000000000000000000000000000000000001111111
1111110000000000000000000000000000000000000000000000000000000000000000001111111
1111110000000000000000000000000000000000000000000000000000000000000000001111111
1111110000000000000000000000000000000000000000000000000000000000000000001111111
1111110000000000000000000000000000000000000000000000000000000000000000001111111
1111110000000000000000000000000000000000000000000000000000000000000000001111111
1111110000000000000000000000000000000000000000000000000000000000000000001111111
1111110000000000000000000000000000000C00000000000000000000000000000000001111111
1111110000000000000000000000000000000000000000000000000000000000000000001111111
1111110000000000011111111111111111111111111111111110000000000000000000001111111
1111110000000000011111111111111111111111111111111110000000000000000000001111111
11111100000000000111111111111111111111111111111111100000C0000000000000001111111
1111110000000000000000000000000000000000000011111100000000000000000000001111111
1111110000000000000000000000000000000000000011111100000000000000000000001111111
1111111111111111111111111111111111111111111111111111111111111111111111111111111
1111111111111111111111111111111111111111111111111111111111111111111111111111111
1111111111111111111111111111111111111111111111111111111111111111111111111111111